,filtro,nome_arquivo,ground_truth,qtd_encontrada,qtd_wbc,qtd_rbc,margem_erro,acuracia
0,mean,BloodImage_00000.jpg,19,23,4,19,0.0,1.2105263157894737
1,mean,BloodImage_00001.jpg,18,16,2,14,-0.2222222222222222,0.8888888888888888
2,mean,BloodImage_00002.jpg,15,15,1,14,-0.06666666666666667,1.0
3,mean,BloodImage_00003.jpg,15,18,3,15,0.0,1.2
4,mean,BloodImage_00004.jpg,11,18,3,15,0.36363636363636365,1.6363636363636365
5,mean,BloodImage_00005.jpg,18,20,3,17,-0.05555555555555555,1.1111111111111112
6,mean,BloodImage_00006.jpg,14,14,4,10,-0.2857142857142857,1.0
7,mean,BloodImage_00007.jpg,17,13,2,11,-0.35294117647058826,0.7647058823529411
8,mean,BloodImage_00008.jpg,19,16,5,11,-0.42105263157894735,0.8421052631578947
9,mean,BloodImage_00009.jpg,16,22,4,18,0.125,1.375
10,mean,BloodImage_00010.jpg,16,22,9,13,-0.1875,1.375
11,mean,BloodImage_00011.jpg,17,15,3,12,-0.29411764705882354,0.8823529411764706
12,mean,BloodImage_00012.jpg,16,15,2,13,-0.1875,0.9375
13,mean,BloodImage_00013.jpg,14,16,2,14,0.0,1.1428571428571428
14,mean,BloodImage_00014.jpg,16,12,1,11,-0.3125,0.75
15,mean,BloodImage_00015.jpg,14,18,6,12,-0.14285714285714285,1.2857142857142858
16,mean,BloodImage_00016.jpg,11,12,1,11,0.0,1.0909090909090908
17,mean,BloodImage_00017.jpg,16,13,3,10,-0.375,0.8125
18,mean,BloodImage_00018.jpg,21,12,2,10,-0.5238095238095238,0.5714285714285714
19,mean,BloodImage_00019.jpg,16,11,1,10,-0.375,0.6875
20,mean,BloodImage_00020.jpg,19,10,1,9,-0.5263157894736842,0.5263157894736842
21,mean,BloodImage_00021.jpg,16,11,1,10,-0.375,0.6875
22,mean,BloodImage_00022.jpg,12,14,1,13,0.08333333333333333,1.1666666666666667
23,mean,BloodImage_00023.jpg,16,12,1,11,-0.3125,0.75
24,mean,BloodImage_00024.jpg,15,9,1,8,-0.4666666666666667,0.6
25,mean,BloodImage_00026.jpg,16,16,1,15,-0.0625,1.0
26,mean,BloodImage_00028.jpg,21,19,4,15,-0.2857142857142857,0.9047619047619048
27,mean,BloodImage_00029.jpg,22,12,2,10,-0.5454545454545454,0.5454545454545454
28,mean,BloodImage_00030.jpg,21,13,2,11,-0.47619047619047616,0.6190476190476191
29,mean,BloodImage_00031.jpg,18,11,2,9,-0.5,0.6111111111111112
30,mean,BloodImage_00032.jpg,23,11,1,10,-0.5652173913043478,0.4782608695652174
31,mean,BloodImage_00033.jpg,18,8,1,7,-0.6111111111111112,0.4444444444444444
32,mean,BloodImage_00034.jpg,15,12,3,9,-0.4,0.8
33,mean,BloodImage_00035.jpg,19,10,1,9,-0.5263157894736842,0.5263157894736842
34,mean,BloodImage_00036.jpg,18,16,3,13,-0.2777777777777778,0.8888888888888888
35,mean,BloodImage_00037.jpg,27,12,1,11,-0.5925925925925926,0.4444444444444444
36,mean,BloodImage_00038.jpg,25,13,1,12,-0.52,0.52
37,mean,BloodImage_00039.jpg,16,15,1,14,-0.125,0.9375
38,mean,BloodImage_00040.jpg,14,15,3,12,-0.14285714285714285,1.0714285714285714
39,mean,BloodImage_00041.jpg,17,15,2,13,-0.23529411764705882,0.8823529411764706
40,mean,BloodImage_00042.jpg,13,7,2,5,-0.6153846153846154,0.5384615384615384
41,mean,BloodImage_00043.jpg,12,12,1,11,-0.08333333333333333,1.0
42,mean,BloodImage_00044.jpg,13,14,2,12,-0.07692307692307693,1.0769230769230769
43,mean,BloodImage_00045.jpg,23,15,1,14,-0.391304347826087,0.6521739130434783
44,mean,BloodImage_00046.jpg,22,13,1,12,-0.45454545454545453,0.5909090909090909
45,mean,BloodImage_00047.jpg,17,11,2,9,-0.47058823529411764,0.6470588235294118
46,mean,BloodImage_00048.jpg,15,12,1,11,-0.26666666666666666,0.8
47,mean,BloodImage_00049.jpg,17,13,1,12,-0.29411764705882354,0.7647058823529411
48,mean,BloodImage_00050.jpg,10,12,1,11,0.1,1.2
49,mean,BloodImage_00052.jpg,15,14,2,12,-0.2,0.9333333333333333
50,mean,BloodImage_00053.jpg,11,13,1,12,0.09090909090909091,1.1818181818181819
51,mean,BloodImage_00054.jpg,13,14,1,13,0.0,1.0769230769230769
52,mean,BloodImage_00055.jpg,10,11,1,10,0.0,1.1
53,mean,BloodImage_00056.jpg,11,14,1,13,0.18181818181818182,1.2727272727272727
54,mean,BloodImage_00057.jpg,8,9,1,8,0.0,1.125
55,mean,BloodImage_00058.jpg,8,10,1,9,0.125,1.25
56,mean,BloodImage_00059.jpg,12,8,1,7,-0.4166666666666667,0.6666666666666666
57,mean,BloodImage_00062.jpg,11,14,1,13,0.18181818181818182,1.2727272727272727
58,mean,BloodImage_00063.jpg,9,11,2,9,0.0,1.2222222222222223
59,mean,BloodImage_00064.jpg,10,13,1,12,0.2,1.3
60,mean,BloodImage_00065.jpg,5,8,2,6,0.2,1.6
61,mean,BloodImage_00066.jpg,8,6,1,5,-0.375,0.75
62,mean,BloodImage_00067.jpg,11,10,1,9,-0.18181818181818182,0.9090909090909091
63,mean,BloodImage_00068.jpg,9,8,1,7,-0.2222222222222222,0.8888888888888888
64,mean,BloodImage_00069.jpg,12,15,1,14,0.16666666666666666,1.25
65,mean,BloodImage_00070.jpg,10,14,2,12,0.2,1.4
66,mean,BloodImage_00071.jpg,8,9,1,8,0.0,1.125
67,mean,BloodImage_00072.jpg,3,8,1,7,1.3333333333333333,2.6666666666666665
68,mean,BloodImage_00073.jpg,11,12,1,11,0.0,1.0909090909090908
69,mean,BloodImage_00074.jpg,13,13,1,12,-0.07692307692307693,1.0
70,mean,BloodImage_00075.jpg,10,11,2,9,-0.1,1.1
71,mean,BloodImage_00076.jpg,11,11,1,10,-0.09090909090909091,1.0
72,mean,BloodImage_00077.jpg,8,9,1,8,0.0,1.125
73,mean,BloodImage_00078.jpg,11,12,1,11,0.0,1.0909090909090908
74,mean,BloodImage_00079.jpg,15,13,1,12,-0.2,0.8666666666666667
75,mean,BloodImage_00081.jpg,14,11,1,10,-0.2857142857142857,0.7857142857142857
76,mean,BloodImage_00082.jpg,10,14,1,13,0.3,1.4
77,mean,BloodImage_00083.jpg,13,9,1,8,-0.38461538461538464,0.6923076923076923
78,mean,BloodImage_00086.jpg,10,12,1,11,0.1,1.2
79,mean,BloodImage_00087.jpg,7,8,1,7,0.0,1.1428571428571428
80,mean,BloodImage_00088.jpg,10,9,1,8,-0.2,0.9
81,mean,BloodImage_00089.jpg,10,12,1,11,0.1,1.2
82,mean,BloodImage_00090.jpg,12,11,1,10,-0.16666666666666666,0.9166666666666666
83,mean,BloodImage_00091.jpg,9,6,1,5,-0.4444444444444444,0.6666666666666666
84,mean,BloodImage_00092.jpg,12,13,1,12,0.0,1.0833333333333333
85,mean,BloodImage_00093.jpg,11,10,1,9,-0.18181818181818182,0.9090909090909091
86,mean,BloodImage_00094.jpg,17,21,2,19,0.11764705882352941,1.2352941176470589
87,mean,BloodImage_00095.jpg,15,18,3,15,0.0,1.2
88,mean,BloodImage_00097.jpg,16,16,0,16,0.0,1.0
89,mean,BloodImage_00098.jpg,13,20,3,17,0.3076923076923077,1.5384615384615385
90,mean,BloodImage_00099.jpg,15,16,1,15,0.0,1.0666666666666667
91,mean,BloodImage_00100.jpg,15,15,4,11,-0.26666666666666666,1.0
92,mean,BloodImage_00101.jpg,13,14,1,13,0.0,1.0769230769230769
93,mean,BloodImage_00103.jpg,16,12,1,11,-0.3125,0.75
94,mean,BloodImage_00104.jpg,14,18,3,15,0.07142857142857142,1.2857142857142858
95,mean,BloodImage_00106.jpg,15,18,2,16,0.06666666666666667,1.2
96,mean,BloodImage_00107.jpg,12,16,2,14,0.16666666666666666,1.3333333333333333
97,mean,BloodImage_00108.jpg,14,17,2,15,0.07142857142857142,1.2142857142857142
98,mean,BloodImage_00109.jpg,11,15,2,13,0.18181818181818182,1.3636363636363635
99,mean,BloodImage_00110.jpg,10,11,1,10,0.0,1.1
100,mean,BloodImage_00111.jpg,15,17,1,16,0.06666666666666667,1.1333333333333333
101,mean,BloodImage_00112.jpg,13,12,1,11,-0.15384615384615385,0.9230769230769231
102,mean,BloodImage_00113.jpg,11,14,1,13,0.18181818181818182,1.2727272727272727
103,mean,BloodImage_00114.jpg,14,18,1,17,0.21428571428571427,1.2857142857142858
104,mean,BloodImage_00115.jpg,14,13,1,12,-0.14285714285714285,0.9285714285714286
105,mean,BloodImage_00117.jpg,10,14,2,12,0.2,1.4
106,mean,BloodImage_00120.jpg,9,13,1,12,0.3333333333333333,1.4444444444444444
107,mean,BloodImage_00123.jpg,8,14,2,12,0.5,1.75
108,mean,BloodImage_00124.jpg,10,13,2,11,0.1,1.3
109,mean,BloodImage_00125.jpg,10,13,1,12,0.2,1.3
110,mean,BloodImage_00126.jpg,11,11,1,10,-0.09090909090909091,1.0
111,mean,BloodImage_00127.jpg,5,11,1,10,1.0,2.2
112,mean,BloodImage_00130.jpg,8,12,1,11,0.375,1.5
113,mean,BloodImage_00132.jpg,7,12,1,11,0.5714285714285714,1.7142857142857142
114,mean,BloodImage_00133.jpg,9,12,1,11,0.2222222222222222,1.3333333333333333
115,mean,BloodImage_00135.jpg,10,13,2,11,0.1,1.3
116,mean,BloodImage_00136.jpg,9,12,1,11,0.2222222222222222,1.3333333333333333
117,mean,BloodImage_00137.jpg,5,8,2,6,0.2,1.6
118,mean,BloodImage_00139.jpg,9,15,1,14,0.5555555555555556,1.6666666666666667
119,mean,BloodImage_00140.jpg,8,11,1,10,0.25,1.375
120,mean,BloodImage_00141.jpg,9,14,0,14,0.5555555555555556,1.5555555555555556
121,mean,BloodImage_00142.jpg,6,11,1,10,0.6666666666666666,1.8333333333333333
122,mean,BloodImage_00143.jpg,5,8,1,7,0.4,1.6
123,mean,BloodImage_00144.jpg,9,7,1,6,-0.3333333333333333,0.7777777777777778
124,mean,BloodImage_00145.jpg,10,17,1,16,0.6,1.7
125,mean,BloodImage_00148.jpg,4,6,1,5,0.25,1.5
126,mean,BloodImage_00149.jpg,8,10,2,8,0.0,1.25
127,mean,BloodImage_00154.jpg,6,10,1,9,0.5,1.6666666666666667
128,mean,BloodImage_00156.jpg,9,7,1,6,-0.3333333333333333,0.7777777777777778
129,mean,BloodImage_00157.jpg,3,6,0,6,1.0,2.0
130,mean,BloodImage_00158.jpg,5,11,2,9,0.8,2.2
131,mean,BloodImage_00159.jpg,5,11,1,10,1.0,2.2
132,mean,BloodImage_00160.jpg,9,12,0,12,0.3333333333333333,1.3333333333333333
133,mean,BloodImage_00161.jpg,13,14,1,13,0.0,1.0769230769230769
134,mean,BloodImage_00162.jpg,11,17,0,17,0.5454545454545454,1.5454545454545454
135,mean,BloodImage_00163.jpg,6,13,1,12,1.0,2.1666666666666665
136,mean,BloodImage_00164.jpg,10,9,0,9,-0.1,0.9
137,mean,BloodImage_00165.jpg,10,19,1,18,0.8,1.9
138,mean,BloodImage_00166.jpg,11,18,2,16,0.45454545454545453,1.6363636363636365
139,mean,BloodImage_00167.jpg,14,18,0,18,0.2857142857142857,1.2857142857142858
140,mean,BloodImage_00168.jpg,16,18,0,18,0.125,1.125
141,mean,BloodImage_00169.jpg,16,17,0,17,0.0625,1.0625
142,mean,BloodImage_00170.jpg,13,18,0,18,0.38461538461538464,1.3846153846153846
143,mean,BloodImage_00171.jpg,13,22,0,22,0.6923076923076923,1.6923076923076923
144,mean,BloodImage_00172.jpg,14,22,1,21,0.5,1.5714285714285714
145,mean,BloodImage_00174.jpg,13,22,0,22,0.6923076923076923,1.6923076923076923
146,mean,BloodImage_00175.jpg,9,15,0,15,0.6666666666666666,1.6666666666666667
147,mean,BloodImage_00176.jpg,11,16,3,13,0.18181818181818182,1.4545454545454546
148,mean,BloodImage_00177.jpg,11,20,0,20,0.8181818181818182,1.8181818181818181
149,mean,BloodImage_00178.jpg,12,19,1,18,0.5,1.5833333333333333
150,mean,BloodImage_00179.jpg,12,20,0,20,0.6666666666666666,1.6666666666666667
151,mean,BloodImage_00180.jpg,10,19,1,18,0.8,1.9
152,mean,BloodImage_00182.jpg,9,21,3,18,1.0,2.3333333333333335
153,mean,BloodImage_00183.jpg,7,14,2,12,0.7142857142857143,2.0
154,mean,BloodImage_00184.jpg,9,22,2,20,1.2222222222222223,2.4444444444444446
155,mean,BloodImage_00187.jpg,6,17,0,17,1.8333333333333333,2.8333333333333335
156,mean,BloodImage_00189.jpg,13,16,1,15,0.15384615384615385,1.2307692307692308
157,mean,BloodImage_00190.jpg,12,17,1,16,0.3333333333333333,1.4166666666666667
158,mean,BloodImage_00191.jpg,14,10,1,9,-0.35714285714285715,0.7142857142857143
159,mean,BloodImage_00192.jpg,11,15,2,13,0.18181818181818182,1.3636363636363635
160,mean,BloodImage_00193.jpg,7,15,1,14,1.0,2.142857142857143
161,mean,BloodImage_00195.jpg,10,16,1,15,0.5,1.6
162,mean,BloodImage_00196.jpg,10,14,2,12,0.2,1.4
163,mean,BloodImage_00197.jpg,11,17,1,16,0.45454545454545453,1.5454545454545454
164,mean,BloodImage_00198.jpg,14,18,1,17,0.21428571428571427,1.2857142857142858
165,mean,BloodImage_00199.jpg,10,18,0,18,0.8,1.8
166,mean,BloodImage_00200.jpg,9,18,1,17,0.8888888888888888,2.0
167,mean,BloodImage_00201.jpg,9,14,0,14,0.5555555555555556,1.5555555555555556
168,mean,BloodImage_00202.jpg,12,14,1,13,0.08333333333333333,1.1666666666666667
169,mean,BloodImage_00203.jpg,9,13,0,13,0.4444444444444444,1.4444444444444444
170,mean,BloodImage_00204.jpg,14,18,0,18,0.2857142857142857,1.2857142857142858
171,mean,BloodImage_00205.jpg,13,21,0,21,0.6153846153846154,1.6153846153846154
172,mean,BloodImage_00206.jpg,14,16,1,15,0.07142857142857142,1.1428571428571428
173,mean,BloodImage_00207.jpg,11,20,0,20,0.8181818181818182,1.8181818181818181
174,mean,BloodImage_00208.jpg,13,17,2,15,0.15384615384615385,1.3076923076923077
175,mean,BloodImage_00209.jpg,11,16,1,15,0.36363636363636365,1.4545454545454546
176,mean,BloodImage_00210.jpg,12,17,0,17,0.4166666666666667,1.4166666666666667
177,mean,BloodImage_00211.jpg,12,14,1,13,0.08333333333333333,1.1666666666666667
178,mean,BloodImage_00212.jpg,13,22,0,22,0.6923076923076923,1.6923076923076923
179,mean,BloodImage_00214.jpg,15,18,2,16,0.06666666666666667,1.2
180,mean,BloodImage_00215.jpg,13,16,0,16,0.23076923076923078,1.2307692307692308
181,mean,BloodImage_00216.jpg,15,20,1,19,0.26666666666666666,1.3333333333333333
182,mean,BloodImage_00217.jpg,12,14,1,13,0.08333333333333333,1.1666666666666667
183,mean,BloodImage_00218.jpg,10,17,0,17,0.7,1.7
184,mean,BloodImage_00219.jpg,8,16,0,16,1.0,2.0
185,mean,BloodImage_00220.jpg,9,16,1,15,0.6666666666666666,1.7777777777777777
186,mean,BloodImage_00221.jpg,10,20,1,19,0.9,2.0
187,mean,BloodImage_00222.jpg,9,14,3,11,0.2222222222222222,1.5555555555555556
188,mean,BloodImage_00223.jpg,12,19,0,19,0.5833333333333334,1.5833333333333333
189,mean,BloodImage_00225.jpg,13,18,4,14,0.07692307692307693,1.3846153846153846
190,mean,BloodImage_00226.jpg,15,19,3,16,0.06666666666666667,1.2666666666666666
191,mean,BloodImage_00227.jpg,11,19,0,19,0.7272727272727273,1.7272727272727273
192,mean,BloodImage_00228.jpg,11,13,1,12,0.09090909090909091,1.1818181818181819
193,mean,BloodImage_00229.jpg,10,15,1,14,0.4,1.5
194,mean,BloodImage_00230.jpg,10,20,0,20,1.0,2.0
195,mean,BloodImage_00231.jpg,8,15,0,15,0.875,1.875
196,mean,BloodImage_00232.jpg,9,18,2,16,0.7777777777777778,2.0
197,mean,BloodImage_00233.jpg,6,14,2,12,1.0,2.3333333333333335
198,mean,BloodImage_00234.jpg,10,17,0,17,0.7,1.7
199,mean,BloodImage_00235.jpg,3,13,0,13,3.3333333333333335,4.333333333333333
200,mean,BloodImage_00236.jpg,6,15,0,15,1.5,2.5
201,mean,BloodImage_00237.jpg,11,16,0,16,0.45454545454545453,1.4545454545454546
202,mean,BloodImage_00239.jpg,11,20,0,20,0.8181818181818182,1.8181818181818181
203,mean,BloodImage_00240.jpg,8,19,0,19,1.375,2.375
204,mean,BloodImage_00241.jpg,6,15,2,13,1.1666666666666667,2.5
205,mean,BloodImage_00242.jpg,14,20,0,20,0.42857142857142855,1.4285714285714286
206,mean,BloodImage_00243.jpg,11,20,0,20,0.8181818181818182,1.8181818181818181
207,mean,BloodImage_00244.jpg,14,22,0,22,0.5714285714285714,1.5714285714285714
208,mean,BloodImage_00245.jpg,15,22,0,22,0.4666666666666667,1.4666666666666666
209,mean,BloodImage_00246.jpg,12,20,0,20,0.6666666666666666,1.6666666666666667
210,mean,BloodImage_00247.jpg,13,21,1,20,0.5384615384615384,1.6153846153846154
211,mean,BloodImage_00248.jpg,11,17,0,17,0.5454545454545454,1.5454545454545454
212,mean,BloodImage_00251.jpg,8,18,0,18,1.25,2.25
213,mean,BloodImage_00252.jpg,9,16,0,16,0.7777777777777778,1.7777777777777777
214,mean,BloodImage_00253.jpg,9,18,0,18,1.0,2.0
215,mean,BloodImage_00254.jpg,9,12,1,11,0.2222222222222222,1.3333333333333333
216,mean,BloodImage_00255.jpg,11,20,5,15,0.36363636363636365,1.8181818181818181
217,mean,BloodImage_00256.jpg,5,20,0,20,3.0,4.0
218,mean,BloodImage_00257.jpg,7,19,0,19,1.7142857142857142,2.7142857142857144
219,mean,BloodImage_00259.jpg,7,15,2,13,0.8571428571428571,2.142857142857143
220,mean,BloodImage_00260.jpg,5,22,1,21,3.2,4.4
221,mean,BloodImage_00261.jpg,8,20,2,18,1.25,2.5
222,mean,BloodImage_00262.jpg,9,15,1,14,0.5555555555555556,1.6666666666666667
223,mean,BloodImage_00263.jpg,12,18,0,18,0.5,1.5
224,mean,BloodImage_00264.jpg,13,19,1,18,0.38461538461538464,1.4615384615384615
225,mean,BloodImage_00265.jpg,10,19,2,17,0.7,1.9
226,mean,BloodImage_00266.jpg,12,15,2,13,0.08333333333333333,1.25
227,mean,BloodImage_00269.jpg,8,15,0,15,0.875,1.875
228,mean,BloodImage_00270.jpg,3,17,1,16,4.333333333333333,5.666666666666667
229,mean,BloodImage_00271.jpg,11,16,1,15,0.36363636363636365,1.4545454545454546
230,mean,BloodImage_00272.jpg,13,21,1,20,0.5384615384615384,1.6153846153846154
231,mean,BloodImage_00273.jpg,12,17,1,16,0.3333333333333333,1.4166666666666667
232,mean,BloodImage_00274.jpg,6,13,0,13,1.1666666666666667,2.1666666666666665
233,mean,BloodImage_00275.jpg,14,20,1,19,0.35714285714285715,1.4285714285714286
234,mean,BloodImage_00276.jpg,12,16,2,14,0.16666666666666666,1.3333333333333333
235,mean,BloodImage_00277.jpg,13,19,0,19,0.46153846153846156,1.4615384615384615
236,mean,BloodImage_00278.jpg,12,15,1,14,0.16666666666666666,1.25
237,mean,BloodImage_00279.jpg,13,20,0,20,0.5384615384615384,1.5384615384615385
238,mean,BloodImage_00281.jpg,10,8,0,8,-0.2,0.8
239,mean,BloodImage_00282.jpg,14,17,0,17,0.21428571428571427,1.2142857142857142
240,mean,BloodImage_00283.jpg,12,19,3,16,0.3333333333333333,1.5833333333333333
241,mean,BloodImage_00284.jpg,10,15,0,15,0.5,1.5
242,mean,BloodImage_00285.jpg,11,18,0,18,0.6363636363636364,1.6363636363636365
243,mean,BloodImage_00287.jpg,14,22,0,22,0.5714285714285714,1.5714285714285714
244,mean,BloodImage_00288.jpg,18,22,0,22,0.2222222222222222,1.2222222222222223
245,mean,BloodImage_00289.jpg,10,21,0,21,1.1,2.1
246,mean,BloodImage_00290.jpg,11,21,0,21,0.9090909090909091,1.9090909090909092
247,mean,BloodImage_00291.jpg,9,22,0,22,1.4444444444444444,2.4444444444444446
248,mean,BloodImage_00292.jpg,13,22,0,22,0.6923076923076923,1.6923076923076923
249,mean,BloodImage_00293.jpg,10,15,0,15,0.5,1.5
250,mean,BloodImage_00294.jpg,10,20,0,20,1.0,2.0
251,mean,BloodImage_00295.jpg,11,16,0,16,0.45454545454545453,1.4545454545454546
252,mean,BloodImage_00296.jpg,12,18,1,17,0.4166666666666667,1.5
253,mean,BloodImage_00297.jpg,9,18,1,17,0.8888888888888888,2.0
254,mean,BloodImage_00298.jpg,9,18,1,17,0.8888888888888888,2.0
255,mean,BloodImage_00299.jpg,8,19,1,18,1.25,2.375
256,mean,BloodImage_00300.jpg,13,19,2,17,0.3076923076923077,1.4615384615384615
257,mean,BloodImage_00301.jpg,13,21,3,18,0.38461538461538464,1.6153846153846154
258,mean,BloodImage_00302.jpg,12,12,1,11,-0.08333333333333333,1.0
259,mean,BloodImage_00304.jpg,11,16,0,16,0.45454545454545453,1.4545454545454546
260,mean,BloodImage_00305.jpg,13,17,1,16,0.23076923076923078,1.3076923076923077
261,mean,BloodImage_00307.jpg,12,14,2,12,0.0,1.1666666666666667
262,mean,BloodImage_00308.jpg,11,16,0,16,0.45454545454545453,1.4545454545454546
263,mean,BloodImage_00309.jpg,12,20,2,18,0.5,1.6666666666666667
264,mean,BloodImage_00310.jpg,11,16,0,16,0.45454545454545453,1.4545454545454546
265,mean,BloodImage_00311.jpg,8,15,1,14,0.75,1.875
266,mean,BloodImage_00312.jpg,7,15,0,15,1.1428571428571428,2.142857142857143
267,mean,BloodImage_00313.jpg,10,15,0,15,0.5,1.5
268,mean,BloodImage_00314.jpg,10,17,2,15,0.5,1.7
269,mean,BloodImage_00315.jpg,10,12,0,12,0.2,1.2
270,mean,BloodImage_00317.jpg,13,21,1,20,0.5384615384615384,1.6153846153846154
271,mean,BloodImage_00318.jpg,11,16,1,15,0.36363636363636365,1.4545454545454546
272,mean,BloodImage_00319.jpg,10,19,0,19,0.9,1.9
273,mean,BloodImage_00320.jpg,11,16,0,16,0.45454545454545453,1.4545454545454546
274,mean,BloodImage_00323.jpg,5,21,0,21,3.2,4.2
275,mean,BloodImage_00324.jpg,11,18,2,16,0.45454545454545453,1.6363636363636365
276,mean,BloodImage_00325.jpg,11,19,0,19,0.7272727272727273,1.7272727272727273
277,mean,BloodImage_00326.jpg,10,19,0,19,0.9,1.9
278,mean,BloodImage_00331.jpg,14,24,0,24,0.7142857142857143,1.7142857142857142
279,mean,BloodImage_00332.jpg,9,24,0,24,1.6666666666666667,2.6666666666666665
280,mean,BloodImage_00333.jpg,14,20,0,20,0.42857142857142855,1.4285714285714286
281,mean,BloodImage_00334.jpg,10,19,1,18,0.8,1.9
282,mean,BloodImage_00335.jpg,11,19,0,19,0.7272727272727273,1.7272727272727273
283,mean,BloodImage_00336.jpg,10,16,0,16,0.6,1.6
284,mean,BloodImage_00337.jpg,13,17,0,17,0.3076923076923077,1.3076923076923077
285,mean,BloodImage_00338.jpg,13,17,0,17,0.3076923076923077,1.3076923076923077
286,mean,BloodImage_00339.jpg,15,23,1,22,0.4666666666666667,1.5333333333333334
287,mean,BloodImage_00340.jpg,11,15,0,15,0.36363636363636365,1.3636363636363635
288,mean,BloodImage_00341.jpg,9,19,2,17,0.8888888888888888,2.111111111111111
289,mean,BloodImage_00342.jpg,8,16,2,14,0.75,2.0
290,mean,BloodImage_00343.jpg,9,17,0,17,0.8888888888888888,1.8888888888888888
291,mean,BloodImage_00344.jpg,12,17,0,17,0.4166666666666667,1.4166666666666667
292,mean,BloodImage_00345.jpg,12,19,0,19,0.5833333333333334,1.5833333333333333
293,mean,BloodImage_00346.jpg,13,18,0,18,0.38461538461538464,1.3846153846153846
294,mean,BloodImage_00347.jpg,18,20,0,20,0.1111111111111111,1.1111111111111112
295,mean,BloodImage_00348.jpg,14,18,0,18,0.2857142857142857,1.2857142857142858
296,mean,BloodImage_00349.jpg,13,17,0,17,0.3076923076923077,1.3076923076923077
297,mean,BloodImage_00351.jpg,14,18,0,18,0.2857142857142857,1.2857142857142858
298,mean,BloodImage_00352.jpg,12,19,0,19,0.5833333333333334,1.5833333333333333
299,mean,BloodImage_00353.jpg,13,21,0,21,0.6153846153846154,1.6153846153846154
300,mean,BloodImage_00354.jpg,15,20,0,20,0.3333333333333333,1.3333333333333333
301,mean,BloodImage_00355.jpg,14,20,0,20,0.42857142857142855,1.4285714285714286
302,mean,BloodImage_00356.jpg,16,20,1,19,0.1875,1.25
303,mean,BloodImage_00357.jpg,13,20,0,20,0.5384615384615384,1.5384615384615385
304,mean,BloodImage_00359.jpg,14,23,0,23,0.6428571428571429,1.6428571428571428
305,mean,BloodImage_00360.jpg,11,17,0,17,0.5454545454545454,1.5454545454545454
306,mean,BloodImage_00361.jpg,14,17,0,17,0.21428571428571427,1.2142857142857142
307,mean,BloodImage_00362.jpg,11,17,0,17,0.5454545454545454,1.5454545454545454
308,mean,BloodImage_00364.jpg,14,18,0,18,0.2857142857142857,1.2857142857142858
309,mean,BloodImage_00365.jpg,12,17,0,17,0.4166666666666667,1.4166666666666667
310,mean,BloodImage_00366.jpg,14,17,0,17,0.21428571428571427,1.2142857142857142
311,mean,BloodImage_00367.jpg,14,15,0,15,0.07142857142857142,1.0714285714285714
312,mean,BloodImage_00368.jpg,13,23,0,23,0.7692307692307693,1.7692307692307692
313,mean,BloodImage_00369.jpg,17,21,0,21,0.23529411764705882,1.2352941176470589
314,mean,BloodImage_00370.jpg,14,20,0,20,0.42857142857142855,1.4285714285714286
315,mean,BloodImage_00371.jpg,12,17,0,17,0.4166666666666667,1.4166666666666667
316,mean,BloodImage_00372.jpg,12,15,0,15,0.25,1.25
317,mean,BloodImage_00374.jpg,9,16,0,16,0.7777777777777778,1.7777777777777777
318,mean,BloodImage_00375.jpg,12,18,0,18,0.5,1.5
319,mean,BloodImage_00376.jpg,10,19,0,19,0.9,1.9
320,mean,BloodImage_00377.jpg,13,16,0,16,0.23076923076923078,1.2307692307692308
321,mean,BloodImage_00378.jpg,15,20,0,20,0.3333333333333333,1.3333333333333333
322,mean,BloodImage_00379.jpg,18,21,0,21,0.16666666666666666,1.1666666666666667
323,mean,BloodImage_00381.jpg,15,22,0,22,0.4666666666666667,1.4666666666666666
324,mean,BloodImage_00382.jpg,13,22,0,22,0.6923076923076923,1.6923076923076923
325,mean,BloodImage_00383.jpg,8,14,0,14,0.75,1.75
326,mean,BloodImage_00384.jpg,10,15,0,15,0.5,1.5
327,mean,BloodImage_00385.jpg,14,17,0,17,0.21428571428571427,1.2142857142857142
328,mean,BloodImage_00386.jpg,14,17,0,17,0.21428571428571427,1.2142857142857142
329,mean,BloodImage_00387.jpg,10,12,0,12,0.2,1.2
330,mean,BloodImage_00388.jpg,10,10,0,10,0.0,1.0
331,mean,BloodImage_00389.jpg,5,6,0,6,0.2,1.2
332,mean,BloodImage_00390.jpg,10,10,0,10,0.0,1.0
333,mean,BloodImage_00391.jpg,14,16,0,16,0.14285714285714285,1.1428571428571428
334,mean,BloodImage_00392.jpg,14,18,0,18,0.2857142857142857,1.2857142857142858
335,mean,BloodImage_00393.jpg,11,14,0,14,0.2727272727272727,1.2727272727272727
336,mean,BloodImage_00395.jpg,14,17,0,17,0.21428571428571427,1.2142857142857142
337,mean,BloodImage_00396.jpg,17,24,0,24,0.4117647058823529,1.411764705882353
338,mean,BloodImage_00397.jpg,17,20,0,20,0.17647058823529413,1.1764705882352942
339,mean,BloodImage_00398.jpg,14,17,0,17,0.21428571428571427,1.2142857142857142
340,mean,BloodImage_00400.jpg,12,18,0,18,0.5,1.5
341,mean,BloodImage_00402.jpg,13,21,0,21,0.6153846153846154,1.6153846153846154
342,mean,BloodImage_00403.jpg,15,17,0,17,0.13333333333333333,1.1333333333333333
343,mean,BloodImage_00404.jpg,13,18,0,18,0.38461538461538464,1.3846153846153846
344,mean,BloodImage_00405.jpg,14,15,0,15,0.07142857142857142,1.0714285714285714
345,mean,BloodImage_00407.jpg,15,19,0,19,0.26666666666666666,1.2666666666666666
346,mean,BloodImage_00408.jpg,15,20,0,20,0.3333333333333333,1.3333333333333333
347,mean,BloodImage_00409.jpg,14,17,0,17,0.21428571428571427,1.2142857142857142
348,mean,BloodImage_00410.jpg,13,19,0,19,0.46153846153846156,1.4615384615384615
